%%%%%%
%    %
% %  %
%Bb .%
%P%%%%
% %%%%
%%%%%%
