%%%%%%%%%%
%%%%   %%%
%%%%Pb  %%
%%%%bbb  %
%%%% b b %
%%%% bb  %
%%%% b  %%
%%%% %%%%%
%%%% ..%%%
%%%% ..%%%
%%%% .%%%%
%%%% ..%%%
%    ..%%%
% % b.%%%%
%   %%%%%%
%%%%%%%%%%
